[ _layouts/default.html (скелет, меню, подвал)              ]
[                                                          ]
[   [ _layouts/home.html (уникальная структура главной) ]   ]
[   [                                                  ]   ]
[   [     [ index.md (ваш текст и картинки) ]          ]   ]
[   [                                                  ]   ]
[   [__________________________________________________]   ]
[                                                          ]
[__________________________________________________________]
